#####################
#...................#
#..........##########
####...##.#######
####...........###############
####.........................#
#............................#
#p...........................#
##############################
