#####################
#.$.#e......##.....##
#.$###..####...e##..#
#.$###..$$$..##..#..#
#.#.#.#.#####...##..#
#.e.$$$..#....###..##
#p..##..####...##..##
#####################
