#####################
#...#...##..##.e##.##
#..###..####....##p.#
#..###..##...##..##.#
#.#.#.#.###########.#
#......e.#...####..##
#...##..####...##e.##
#####################
