##########
#.d.#d..##
#..###..##
#..###..##
#.#.#.#.##
#....p...#
#...##..##
##########
