#####################
#...................#
#..........##########
####...##.#######
####...........###############
####.........................#
#............................#
#p...........d...............#
##############################
