#####################
#.$.#e......##.....##
#.$###..####...e##..#
#.$###..$$$..##..#..#
#.#.#.#.#####...##..#
#.e.$$$..#....###..##
#p..##..####...##.d##
#####################
