#####################
#eee#e.ee...##.eee.##
#ee###ee####...e##ee#
#ee###eee....##..#ee#
#.#.#e#e#####e..##e.#
#.e.eeee.#.e.e###ee##
#p..##.e####ee.##ee##
#####################
