##########
#...#...##
#..###..##
#..###..##
#.#.#.#.##
#........#
#...##..##
##########
