#####################
#.e.#...##..##..##.##
#..###..####..e.##..#
#..###p.##...##..##.#
#.#.#.#.###########.#
#.e....e.#...####..##
#...##..####...##..##
#####################
