#####################
#.$.#e...e..##.....##
#.$###..####...e##..#
#.$###..$$$..##..#..#
#.#.#.#.#####i..##..#
#..i$$$.i#....###..##
#p..##..####...##.d##
#####################
