#####################
#...#...##..##.e##.##
#..###..####....##p.#
#..###..##...##..##d#
#.#.#.#.###########.#
#......e.#...####..##
#...##..####...##e.##
#####################
