#####################
#...#...##..##..##.##
#..###..####....##..#
#..###..##...##..##.#
#.#.#.#.###########.#
#......e.#...####..##
#.p.##..####...##..##
#####################
