##########
#i..#e..##
#i.###..##
#i.###..##
#.#.#.#.##
#.d..p.i.#
#...##..##
##########
